
player: player   (bool:hasflashlight, bool:canRun, bool:canCrouch, vector3:position, quaternion:rotation)
fadeIn: fade_id		(bool:playOnStart)
fadeout: fade_out	(bool:playOnStart)
cat:cat (int:state[deactivated=0|stand=1|help=2], vector3:position, quaternion:rotation ) 
moonController: moon_controller (float:strength)


// {Id}: the object id
cutScenes: cut_{Id}  (bool:playOnStart)
scaryDoor: (bool:isClosed)
activable: activable_{Id}  (bool:activeself)
stateful: state_{id} (int:state)



//// OBJECTS
player: player
cat: cat
moonController: moon_controller
boy for appearance only: scary_boy_appearance (simpleActivator)
girl for appearance only: scary_girl_appearance (simpleActivator)
brokenKitchenDoor: broken_kitchen_door (activator)
kitchenDoorActivator: broken_kitchen_door
kitchenDoor: kitchen_door
booth_door: booth_door


/// CUT SCENES
fadeIn: fade_in
fadeOut: fade_out
firstCut: cut_1

/// Gameplay controllers
EntranceGate: stateful_1
GymScare: stateful_2
EnterTheSchool: floor1_part1
after entering the school: floor1_part2
gym is locked: floor1_part3
in the fog: ext_part1
boy_dorms: boy_dorms_part1
kitchen_hunt: kitchen_hunt

/// Environment
OriginalGym: old_gym (bool:active)
AbandonedGym: abandoned_gym (bool:active)
OriginalKitchen: old_kitchen
AbandonedKitchen: abandoned_kitchen


/// Doors ( ScaryDoor )
Gym internal door: gym_door
first floor door1: floor1_door1
spoiatoio floor door1: floor1_door2
porta piano 1: floor1_door3
dorms_doors: dorms_ext_door1, dorms_ext_door2, dorms_ext_door3, dorms_ext_door4, dorms_f1_door1, dorms_f1_door2, dorms_f1_door3


/// Blocks ( bool:active )
MainEntranceBlock: floor1_block1
Block between first and second floor: stairs_block
gym external door block: gym_block1, gym_block1_n 
kitchen entrance block: kit_block, kit_block_n
meet the girl room block: mtg_block ( TransformSaver )





